%%%%%%%%%%%%%%%
%%.o.........%%
%..%..%.%..%o.%
%P%%%.%.%.%%%.%
%.....%%%....o%
%.%%%.....%%%.%
%..%..%.%..%..%
%%...%%%%%...%%
%%.%.......%.%%
%..%o%%%%%.%G.%
%.%%.......%%.%
%....%%%%%....%
%%%%%%%%%%%%%%%
