%%%%%%%%%
%G.o%...%
%.%...%.%
%.%%%%%.%
%.....oo%
%..%%%P.%
%.%%%%%.%
%..o....%
%%%%%%%%%
%%%%%%%%%
