%%%%%%%%%
%.P.oo..%
%.%%%%%.%
%..%%%..%
%%o..o.%%
%%.%.%G%%
%%.%.%.%%
%%.%.%.%%
%%.....%%
%%%%%%%%%
