%%%%%%%%%
%....G..%
%.%%%%%.%
%...o...%
%.%%%%%.%
%.......%
%.%%%%%.%
%o.%%%..%
%%..oo.%%
%%%%%%%%%
