%%%%%%%%%%%%%%%
%%...........%%
%..%..%%%..%..%
%.%%%.%%%.%%%.%
%.....%%%oP...%
%%.%%...o.%%.%%
%%.%..%%%..%.%%
%%.%G%%%%%o%.%%
%%...o.......%%
%%%%%%%%%%%%%%%
