%%%%%%%%%%%%%%%
%%%%...o...%%%%
%%...%%%%%...%%
%..%o.%%%.o%..%
%.%%%.....%%%.%
%....o%%%.....%
%.%%%.%%%.%%%.%
%.....%%%.....%
%%%%%..G..%%%%%
%%%%%%%%%%%%%%%
