%%%%%%%%%%%%%%%
%......P.o...o%
%.%%%.%%%o%%%.%
%.%...%%%...%.%
%...%.%%%.%...%
%.%.%.....%.%.%
%.%...%%%...%.%
%.%%.%%%%%.%%.%
%.........oG..%
%%%%%%%%%%%%%%%
