%%%%%%%%%%%%%%%
%%%....o....%%%
%...%%.%.%%...%
%%%.%..%..%o%%%
%..P%.%%%.%...%
%.%........o%.%
%.%%.%%%%%.%%.%
%.%.........%.%
%...%%.%.%%...%
%%%.%..%..%.%%%
%...%.%%%.%G..%
%%%....o....%%%
%%%%%%%%%%%%%%%
