%%%%%%%%%%%%%%%
%%%.........%%%
%%..%.%%%.%..%%
%%.%%.%%%.%%.%%
%...%.%%%.%...%
%.%...o.....%.%
%.%%.%%%%%.%%.%
%.%.o.......%P%
%...%.%%%.%..o%
%.%%%.%%%.%%%.%
%.Go..%%%.....%
%%%%%.....%%%%%
%%%%%%%%%%%%%%%
