%%%%%%%%%%%%%%%
%%...o.......%%
%%.%.%%%%%.%.%%
%.....%%%.....%
%.%%%.....%%%.%
%.....%%%....G%
%.%%%.%%%.%%%.%
%...%.%%%o%...%
%.%.........%.%
%o%%.%%%%%.%%.%
%.%...%%%...%.%
%Po.%.....%...%
%%%%%%%%%%%%%%%
