%%%%%%%%%%%%%%%
%%...o....o..%%
%%.%..%%%..%.%%
%%.%.%%%%%.%.%%
%%.%.......%.%%
%%...%%%%%...%%
%..%..%%%..%.o%
%.%%%.....%%%.%
%.....%%%.....%
%.%%%.%%%.%%%.%
%.....%%%.....%
%%%%%.Po..%%%%%
%%%%%%%%%%%%%%%
