%%%%%%%%%%%%%%%
%%%%%.....%%%%%
%.....%.%.....%
%.%%%.%.%.%%%.%
%...P.%.%...o.%
%.%%%.....%%%.%
%..%..%%%.o%..%
%%...%%%%%...%%
%%.%......o%.%%
%%.%.%%%%%.%.%%
%%.%o..%...%.%%
%%...%...%..G%%
%%%%%%%%%%%%%%%
