%%%%%%%%%
%%Po...%%
%o.%%%..%
%o%%%%%.%
%....o..%
%..%%%..%
%.%%%%%.%
%..%%%.G%
%%.....%%
%%%%%%%%%
