%%%%%%%%%%%%%%%
%%...%%%%%...%%
%%.%...P...%.%%
%..%.%%%%%.%..%
%.%%.%o..%.%%.%
%...o..%......%
%.%%%.%%%.%%%.%
%......%......%
%%.%.%...%.%.%%
%%.%.%.%.%.%.%%
%%.%.%..o%.%.%%
%%...G.%o....%%
%%%%%%%%%%%%%%%
