%%%%%%%%%%%%%%%
%%%%%P....%%%%%
%.....%%%.....%
%.%%%.%%%.%%%.%
%...%.%%%.%.G.%
%.%.o.....o.%.%
%.%%.%%%%%.%%.%
%.%.....o...%.%
%...%%%%%%%...%
%%%%%%%%%%%%%%%
