%%%%%%%%%
%.oo%G..%
%.%...%.%
%.%%%%%.%
%..o.o..%
%..%%%..%
%P%%%%%.%
%.......%
%%%%%%%%%
%%%%%%%%%
