%%%%%%%%%
%..G....%
%.%%%%%.%
%o.%%%..%
%.......%
%.%%.%%.%
%.%...%.%
%o%.%.%.%
%.Po....%
%%%%%%%%%
